""
DialogScript	DialogScript
CreateScript	CreateScript
TypePropertiesOptions	TypePropertiesOptions
Help	Help
Tools.shelf	Tools.shelf
InternalFileOptions	InternalFileOptions
Contents.gz	Contents.gz
Version	Version
EditableNodes	EditableNodes
IconSVG	IconSVG
MessageNodes	MessageNodes
PythonModule	PythonModule
OnCreated	OnCreated
ExtraFileOptions	ExtraFileOptions
auto-alluvium.tor	auto-alluvium.tor
auto-breaker.tor	auto-breaker.tor
auto-fold.tor	auto-fold.tor
auto-stratify.tor	auto-stratify.tor
auto-thermal.tor	auto-thermal.tor
auto-erosion.tor	auto-erosion.tor
